##############
#    #       #
# @  #       #
#    #       #
#    ####    #
#            #
#            #
##############